{
  "_": 0,
  " ": 1,
  "!": 2,
  "\"": 3,
  "(": 4,
  ")": 5,
  "-": 6,
  ".": 7,
  ":": 8,
  "[": 9,
  "]": 10,
  "«": 11,
  "»": 12,
  "،": 13,
  "؛": 14,
  "؟": 15,
  "ء": 16,
  "آ": 17,
  "أ": 18,
  "ؤ": 19,
  "إ": 20,
  "ئ": 21,
  "ا": 22,
  "ب": 23,
  "ة": 24,
  "ت": 25,
  "ث": 26,
  "ج": 27,
  "ح": 28,
  "خ": 29,
  "د": 30,
  "ذ": 31,
  "ر": 32,
  "ز": 33,
  "س": 34,
  "ش": 35,
  "ص": 36,
  "ض": 37,
  "ط": 38,
  "ظ": 39,
  "ع": 40,
  "غ": 41,
  "ف": 42,
  "ق": 43,
  "ك": 44,
  "ل": 45,
  "م": 46,
  "ن": 47,
  "ه": 48,
  "و": 49,
  "ى": 50,
  "ي": 51
}